S.##......
#T##..####
#.#....T##
#.E...####
...#.....G